111111
1000P1
1100C1
1E0001
111111